___$$$$$$$$__$$$$$$$$___
___###$####__#####$##___
___##______________##___
___#____________________
________________________
##____________________##
_#____________________#_
_#____________________#_
##____________________##
________________________
____________________#___
___##______________##___
___##$####___####$###___
___$$$$$$$___$$$$$$$$___