$$$$$$$$$$$$$$$$$$$$$$$$
$$_###$########+##$##_$$
$__##________$_____##__$
___#___$________________
________##$$_$##________
##______#______#___$__##
____$___#______#________
________#______#____$___
##____$_#______#______##
________##$$_$##________
___#___$________________
$__##________$_____##__$
$$_###$########+##$##_$$
$$$$$$$$$$$$$$$$$$$$$$$$