$$$$$$$$$$$$$$$$$$$$$$$$
$$_###$########+##$##_$$
$__##___$$$__$_____##__$
___#___$______$$$_______
________##$$_$##________
________#______#___$____
____$___#______#________
________#______#____$___
______$_#______#________
________##$$_$##________
___#___$_____$$$_______
$__##___$$___$_____##__$
$$_###$########+##$##_$$
$$$$$$$$$$$$$$$$$$$$$$$$