___$$$$$$$$__$$$$$$$$___
___###$####__#####$##___
___##______________##___
___#____________________
_________#$$$$#_________
##______#______#______##
_#_________##_________#_
_#_________##_________#_
##______#______#______##
_________#$$$$#_________
____________________#___
___##______________##___
___##$####___####$###___
___$$$$$$$___$$$$$$$$___