$$$$$$$$$$$__$$$$$$$$$$$
$$_###$####__##+##$##_$$
$__##______________##__$
___#_______$$___________
________##$$$$##________
##______#______#______##
B#_________##_________#B
B#_________##_________#B
##______#______#______##
________##$$$$##________
___________$$_______#___
$__##______________##__$
$$_##$####___+###$###_$$
$$$$$$$$$$___$$$$$$$$$$$