$$$$$$$$$$$$$$$$$$$$$$$$
$$$$$$$$$$$$$$$$$$$$$$$$
$$$$$$$$$##$$$$$$$$##$$$
$$$#$$$$$$#$$$$$$$$$##$$
$$$$$$$$$$$$$$$$$$##$$$$
##$$$$$$$$$$$$$$$$$$$$##
B#$$$$$$$$##$$$$$$$$$$#B
B#$$$$$$$$$$$$$$$$$$$$#B
##$$$$$$$$$$$$$$#$$$$$##
$$$$$$$$$$$$$$$$$$$$$$$$
$$$$$###$$##$$$$$$$$$$$$
$$$$$$$$#####$$$$$$##$$$
$$$$$$$$$$$$$$$$$$$##$$$
$$$$$$$$$$$$$$$$$$$$$$$$