$$$$$$$$$$$$$$$$$$$$$$$$
$$$$$$$$$$$$####$$$$$$$$
$$$$$$$$$##$$$$$$$$##$$$
$$$#$$$________$$$$$##$$
$$$$$$$_######_$$$##$$$$
##$$$$$_#____#_$$$$$$$##
B#$$$$$_#_##_#_$$$$$$$#B
B#$$$$$_#_##_#_$$$$$$$#B
##$$$$$_#____#_$#$$$$$##
$$$$$$$_######_$$$$$$$$$
$$$$$##________$$$$$$$$$
$$$$$$##$$$$##$$$$$##$$$
$$$$$##$$$$$##$$$$$##$$$
$$$$$$$$$$$$##$$$$$$$$$$